9 9 9 9 9 9 9 9
1 1 1 9 9 0 0 9
2 1 1 9 9 1 1 9
1 1 1 1 1 1 1 9
1 1 1 1 1 1 1 9
9 9 9 9 9 9 9 9